####################
#S....#.......#....#
#.##.#.#####.#.##..#
#..........#.#..#..#
####.#####.#.##.#..#
#....#...#.#....#..#
#.####.#.#.######..#
#......#.#......#..#
#.######.######.#..#
#.............#...G#
####################