####################
#S............#....#
#.##.#.#####.#.##..#
#...#......#.#..#..#
####.#####.#.##.#..#
#....#...#.#..###..#
#.####.#.#.##.###..#
#......#.#......#..#
#.######.######.#..#
#.............#...G#
####################