####################
#S....#.......#....#
#.##.#.#####.#.##..#
#........#.#.#..#..#
####.###.#.#.##.#..#
#....#...#.#....#..#
#.####.#.########..#
#......#........#..#
#.#############.#..#
#.............#...G#
####################