####################
#S....#.......#....#
#.##.#.#####.#.##..#
#..........#.#..#..#
####.#####.#.##.#..#
#....#...#.#....#..#
#.####.#.#.######..#
#......#.#......#..#
########.######.#..#
#.................G#
####################