####################
#S....#.......#....#
#.##.#.#####.#.##..#
#..........#.#..#..#
####.#######.##.#..#
#....#...#.#....#..#
#.####.#.#.######..#
#......#.#......#..#
#.######.###.##.#..#
#.............#...G#
####################